111111
100101
101001
1100N1
111111

9 = NO
8 = SO
7 = ES
6 = WE

 9 	9  9 	 9 	 9   9
716716716	716	716 717
 8 	8  8 	 8 	 8   8


100101

101001
1100N1
999999
111111